1212121202
2121212121
0000000000
2020202020
0000000000
1100110011
0000110000
1121221211
0000000000
0100000010
0000000000
1111111011
0000000000
0010000100
0000000000
0000000000
1111111111
0000000000
0010000100
0000000000
0001111000
0000000000
0010000100
0000000000
0000000000
1111111111