22222222222
00000000000
11111111111
00000000000
22222222222
00000000000
11111111111
00000000000
22222222222
00000000000
11111111111
00000000000
22222222222
00000000000
11111111111
00000000000
22222222222
00000000000
11111111111
00000000000
22222222222
00000000000
11111111111
00000000000
22222222222