3333333333
3333333333
3333333333
3333333333
2222222222
2222222222
2222222222
0000000000
0030030030
2222222222
0303030303
2222222222
0000000000
2222222222
2222222222
0000000000
2222222222
0000000000
2020202020
0000000000
2222222222