22222222222
20002000002
20002011102
20202011102
20202011102
20202011102
20202011102
20202011102
20202011102
20202011102
20202011102
20202011102
20202011102
20202011102
20202011102
20202011102
20202011102
20202011102
20202011102
20202011102
20202011102
20202011102
20200011102
20200000002
20222222222