1111331111
2211111122
2211111122
1111111111
2222222222
2222222222
2222222222
0000000000
0000000000
2222222222
0000000000
1111111111
0000000000
2222222222
1111111111
1111111111
1111111111
1111111111
1111111111